35	35
██████████████████████████████████████████████████████████████████████
██  ██      ██  ██          ██              ██  ██  ██      ██      ██
██  ██████  ██  ██  ██████  ██  ██  ██████  ██  ██  ██  ██  ██  ██████
██  ██                  ██  ██  ██      ██  ██      ██  ██          ██
██  ██  ██████████████████  ██  ██  ██  ██████████  ██████  ██████████
██          ██          ██      ██  ██  ██      ██      ██          ██
    ██████  ██████  ██  ██  ██  ██████  ██  ██████████  ██  ██████  ██
██  ██  ██      ██  ██      ██  ██      ██                      ██  ██
██████  ██  ██████  ██  ██████  ██  ██████  ██  ██  ██████  ██████  ██
██  ██          ██  ██      ██  ██          ██  ██      ██  ██      ██
██  ██  ██████  ██████  ██  ██████  ██  ██████████████  ██  ██  ██  ██
██      ██  ██  ██      ██      ██  ██          ██  ██  ██  ██  ██    
██████████  ██  ██████████  ██  ██████  ██████████  ██  ██████████████
██  ██  ██  ██  ██  ██      ██      ██  ██      ██          ██  ██  ██
██  ██  ██  ██  ██  ██  ██████  ██████████  ██  ██  ██████████  ██  ██
██              ██  ██  ██      ██      ██  ██              ██      ██
██████  ██  ██  ██  ██  ██  ██████████  ██  ██  ██  ██  ██  ██████  ██
██      ██  ██  ██      ██  ██          ██  ██  ██  ██  ██          ██
██  ██  ██  ██  ██████████████████████  ██████  ██████  ██  ██████  ██
██  ██  ██  ██      ██  ██                  ██  ██      ██  ██      ██
██  ██  ██████  ██████  ██  ██████  ██████  ██████████  ██████  ██████
██  ██      ██  ██      ██  ██      ██      ██          ██  ██      ██
██████  ██████  ██████  ██████████  ██████████████████  ██  ██  ██  ██
██      ██      ██  ██          ██          ██  ██  ██  ██      ██  ██
██████████████  ██  ██████  ██████  ██████  ██  ██  ██████████  ██  ██
██      ██              ██  ██  ██  ██  ██      ██      ██      ██  ██
██████  ██  ██  ██████  ██  ██  ██  ██  ██████  ██  ██████████  ██████
██  ██      ██      ██  ██                  ██  ██      ██          ██
██  ██████████  ██████████  ██  ██  ██  ██████████████  ██  ██████  ██
██      ██          ██      ██  ██  ██      ██              ██      ██
██  ██████  ██  ██████████  ██  ██  ██  ██████████████  ██  ██████  ██
██          ██      ██  ██  ██  ██  ██              ██  ██      ██  ██
██████  ██████████  ██  ██████  ██  ██████████████  ██████  ██████████
██              ██          ██  ██              ██                  ██
██████████████████████████████████████████████████████████████████████
